11111111111111111111111111111111111111111111111111111111111111111111111111111111111111111111111
20000001000000000100000000000001010000000000010100000100000100000000000001000000000000000010001
11010111010111110101111101111101010111111101010101010101110111011111111101110111111100111010101
11010100010000010101000101000101010101000001000101010101000000010000000100010000010000100010101
11010101111111011101011101010101010101011111111101010101111111110111110111011111010111111110101
11010101000001000001000100010100010001010000000001010100000100010001000100010100010000000000101
11011101011101111111110111110111011101010111111111010111110101110101011101110101111111111000101
11000001010001000000000100010100000101000100010000010001000100000101000100010000010000000000101
11011111110101010111110101010111111101111101010111110111011101111101110111011111010111111110101
11010000000101010000010101010001000100010001010000010100010000010001000101000001010101000000101
11011101111101011111010101011101010111010111011111011101011111110111011101111101010101011111101
11000001000101000100010001000100010001010100000001000101010001000100000000000101010101000000101
11111111011101111101111111111111111101010101111111110101110101011111111101111101010101111100101
11000100000001000101000100000001000100000101000000000101000101000001000001000001010100010000101
11010101111111010101010101111101010111111111011101111101011101111101011111011111110101010111101
11010100010000010001010100000100010000010000010001000100010001000001010001010000000101010100001
11010111010111011111010101110111111111010111110111010101110111011111010101010111111101010111101
11010101000100010000010100010001000001000100000100010100010100010100010101000100010001010000001
11010101111101110111110111111101011111111101111101111111110101110101110101111111010111011111011
11010100000000010100010000000001000000000001000001000000000100010001000100000000010001000001011
11010111110111110101011111110111111111111101011111111101111101011101011111111111111101110111011
11010000010001000101000000000100000001000101010000000001000001000100010000000001000001000100001
11011111011111011111111111011101111101010111010111111111011111110101110111111101010001010101111
11010100000000010001000001010001010001010001000101000100000000010101000100000101010001010100001
11010101111111110101011101110111010111011101111101010101111111110111011101110101011111010111101
11010001000000010100000101000100010000010101000000010001000001000100010000010100010100010100001
11011111011111010111111101011101011111110101011111111111011101011101110111011111110101110101111
11010000010001000100010001010001000001000101000100000001000101010001000100010001000101000100001
11010111111101111101010111010101111101010101110111011101110101010111111101110101010101001111101
11010000000100000101010001010101000101010100010000010101000100010000000100000100010101101000001
11011111110101110101111101010101110101011101011111110101011111011111110111011111110101101011111
11000000010101010100010001010101000100010001000001000101000100000000010001010001000101101010001
11010111110101010111010101011101011101110111011111010101110101111111111101010101011101111010101
11010100010001010000010101010001010001000100010000010101000101000100000101010101000100000010101
11011101011111010111110101010111010111011101110111110101011101010101011101110101110111111110101
11000001000001000100010101010001000100010000010001000101010101010001010001000100010000000000101
11011111111101011101010101011101011101111111110111010101010101011111010111011111011101111111101
11000100010001010101000101000001010100000100000100010101010001000101010100010001010001000000001
11110101010111010101111111111111010111110101111101111101011111110101010111010111010111011111111
11000001010000000100000000000000000000010000000000000001000000000001000000010000000100000000003