11111111111111111111111111111111111111111111111111111111111111111111111111111111111111111111111
20000001000000000000010000000000010001000100000100000100000000000101000000111111111100000001010
11110111011111011111011111111101010101010101110111011101111111010101110100000000000000000001010
11000100010001000100010000000001000101010001010100010000010001010000010111111101110111111101010
11011101111101110111010111111101111111011111010101110111110101011111010100000000010000000100000
11000101000001010001000100000001000001000100010100000100000101000000010101111100011111110111111
11010101011101011101111101111111011101110101110111011101111101011101000101010001010000000101010
11010100010100000101000101000000010001000100010001010001000001010101011111010001010111111101000
11010111110111110101010101011111110101011111011101010111011111010101000100011101010000000001110
11010100000100000101010001000100010101000000010101010101000001000101110101010101010100111000000
11110101110101111101111111110101110101111111010101010101111101110100010101010101010100101111110
11000100010100010100000000010001000100000001000101010100000101010111010101010101010111101000000
11011111010111010111111101111101010101110111110101111101110101010001010101010101010100101111010
11000001010000010100000001000001010100010001000100000100010101011101010101010101010110101000010
11010101011111110101110111011111011111011101011111110101110101000001010101010101010000101111110
11010101000001000100010100010001000100010001010000010001000101010001010001010101011111101000000
11010101111101110111010101110001110101110101011101111111011101011111011111000001010100000000000
11010100010101000101010101000001000101000101000001000000010001000000000001111011010101111111110
11010111010101010101011101011101011101011101111101011101110111111111111101000001010101000000000
11010001010100010101000101010001000001010100010101000101000100000000000101010101010101001111111
11111101010111110101110101011111111111010111010101110111011101011111110101010101010101001000000
11000001010000010001010000010000000100010001000101010001000101010000000101010101010101001111110
11011111010111111101011111110111110101110101110101011101110101010111111101111111010101000000000
11010001010100000100010000010000010100010100010100010001000101010001000000000010010101111111011
11010101010101011111010111011101010111010111010111010111011101011101110101111010110000100010000
11010100000101000000010100000101010000010001010101010001010101010000010100010010100010101011110
11011111110101111111110111110111011111110111010101011101010101011111010101010110111111101010000
11010001000101000100010001000001010000000100010101000100010001000101000101010100100000101000111
11010101111101110101011101111101011111011101110101110111111111110101111101010101101110101111100
11010100000100010001000100000100010001000100000100010001000100000100000001010101001010100000000
11010111110111010111011111110111110101110111111111011101010101111101111111010101011010111111110
11000001000001010001000000010100010101010001000000000100010001000001010000010101001010000000000
11011111011101011101110111010101010101011101110111110111111111011111010111110111011011111111110
11010000010001000100010100010101000101000000000101000100000000010001010100000001001000000000010
11110111110111110111110101110101111101111111111101011101111111110101010101111111011011111111010
11000100000100010100000101010100010001000000010000000100000100000100010101010100010010101001000
11011101111101010101111101010111010111011111010111111111110111011111010101010101010110101111111
11010000010001000101000100010000010001010100010001000000010100010001010101010101010000101000010
11011111110111111101000111011111111101010101111111011111010101110101010101010001011110101011110
11000000000000000001000000000000000100000100000000000001000001000100010001000111010010000000003